65 66 66 66 66 66 66 66 66 66 66 66 66 66 66 66 66 66 66 66 66 66 66 66 66 66 66 66 66 66 66 66 66 66 66 66 66 66 66 67
81 82 90 90 90 90 90 82 90 90 90 90 90 90 90 90 90 90 90 90 90 90 90 90 90 90 151 90 151 90 151 90 90 90 90 90 90 151 151 83
81 90 90 90 90 90 90 90 90 90 151 151 151 151 90 90 90 90 90 90 90 90 90 90 90 90 90 90 90 90 90 90 90 90 90 90 90 90 90 83
81 82 90 90 90 90 90 90 90 90 90 90 90 90 90 90 90 90 90 90 90 90 90 90 90 90 90 90 90 90 90 90 90 90 90 90 90 90 90 83
81 82 90 90 90 90 90 90 90 90 90 90 90 90 90 90 90 90 90 90 90 90 90 90 152 90 90 90 90 90 90 90 90 90 90 90 90 90 90 83
81 90 90 90 90 90 90 90 90 86 90 90 90 90 90 90 90 90 90 151 90 90 90 90 90 90 90 90 90 90 90 90 90 90 90 90 90 90 90 83
81 90 90 90 90 90 90 90 90 90 90 90 90 90 90 90 90 90 90 90 90 90 90 90 90 90 90 90 90 90 90 90 90 90 90 90 90 90 90 83
81 90 90 90 90 90 90 90 90 90 90 90 90 90 90 90 90 90 90 90 90 90 90 90 90 90 90 90 90 90 90 90 90 90 90 90 90 90 90 83
81 90 90 90 90 90 90 90 90 90 90 90 90 90 90 90 90 90 90 151 90 90 90 90 90 90 90 90 90 90 90 90 90 90 90 90 90 90 90 83
81 90 90 90 90 90 90 86 90 90 90 90 90 90 90 90 90 90 90 90 90 90 86 90 90 90 90 90 90 90 90 90 90 90 90 90 90 90 90 83
81 90 90 90 90 90 90 90 90 90 90 90 90 90 90 90 90 90 90 90 90 90 90 90 90 90 90 90 90 90 90 90 90 90 90 135 90 90 90 83
81 90 90 90 90 90 90 90 90 90 90 90 90 90 90 90 90 90 90 90 90 90 90 90 90 90 90 90 90 90 90 90 90 90 90 90 90 90 90 83
81 90 90 90 90 90 90 90 90 90 151 90 90 151 90 90 90 90 90 90 90 90 90 90 90 90 90 90 90 90 90 90 90 90 90 90 90 90 90 83
81 90 90 90 90 90 90 90 90 90 90 90 90 90 90 90 90 90 90 90 90 90 90 90 90 90 90 90 90 90 90 90 90 90 90 90 90 90 90 83
81 90 90 90 90 90 90 90 90 90 90 90 90 90 90 90 90 90 90 90 90 90 90 90 90 90 90 90 90 90 90 90 90 90 90 90 90 90 90 83
81 90 90 90 90 90 90 90 152 90 90 90 90 90 90 90 90 90 90 90 90 90 90 90 90 90 90 90 90 90 90 90 90 90 90 90 90 90 90 83
81 90 90 90 90 90 90 90 90 90 90 90 90 90 90 90 90 90 90 90 90 90 90 90 90 90 90 90 90 90 90 90 90 90 90 90 90 90 90 83
81 90 90 90 90 90 90 86 86 86 90 90 90 90 90 90 90 90 90 90 90 90 90 90 90 90 90 90 90 90 90 90 90 90 90 90 90 90 152 83
81 90 90 90 90 90 90 86 86 86 90 90 90 90 90 90 90 90 90 90 90 90 90 90 90 90 90 90 90 90 90 90 90 90 90 90 90 86 86 83
81 90 90 90 90 90 90 86 86 90 90 90 90 90 90 90 90 90 90 90 90 90 90 90 90 90 90 90 90 90 90 90 90 90 90 90 90 86 86 83
81 151 90 90 90 90 90 86 86 86 90 90 90 90 90 90 90 90 90 90 90 90 90 90 90 90 90 90 90 90 90 90 90 90 90 90 90 86 86 83
81 90 90 90 90 90 90 86 86 86 90 90 90 90 90 90 90 90 90 90 90 90 90 90 90 151 90 90 90 90 90 90 90 90 90 90 90 90 86 83
81 90 90 90 90 90 90 90 86 86 86 90 90 90 86 86 90 90 90 90 90 90 90 90 90 90 90 90 90 90 90 90 90 90 90 90 90 90 90 83
81 90 90 90 90 90 90 90 86 86 90 90 90 90 86 86 90 90 90 90 90 90 90 90 90 90 90 90 90 90 90 90 90 90 90 90 90 86 90 83
81 90 90 90 90 90 90 90 90 90 90 90 90 86 86 90 90 90 90 90 90 90 90 90 90 90 90 90 90 90 90 90 90 90 90 90 90 90 90 83
81 90 90 90 90 90 90 90 90 90 90 90 86 86 86 86 90 90 90 90 90 90 90 90 90 90 90 90 90 90 90 86 90 90 90 90 90 90 90 83
81 90 90 90 90 90 90 90 90 90 90 90 86 86 86 86 90 90 90 90 90 90 90 90 90 90 90 86 86 86 86 86 90 90 90 90 90 90 90 83
81 90 90 90 90 90 90 90 90 90 90 90 90 86 90 90 90 90 90 90 90 90 90 90 90 90 86 86 86 86 86 86 86 90 90 90 82 90 82 83
81 90 90 90 90 90 90 90 90 90 90 90 90 90 90 90 90 90 90 90 90 90 90 90 90 86 86 86 86 90 90 90 90 90 90 90 90 90 90 83
81 90 90 90 90 90 90 90 90 90 90 90 90 90 90 86 90 90 90 90 90 90 90 90 90 86 86 86 86 90 90 90 90 90 90 90 90 90 90 83
81 90 90 90 90 90 90 90 90 90 90 90 90 90 90 90 90 90 70 90 90 90 90 90 90 90 90 90 90 90 90 90 90 90 90 90 70 70 70 83
81 90 90 90 90 90 90 90 90 90 90 90 90 90 90 90 90 90 90 90 90 90 90 90 90 90 90 90 90 90 90 90 90 86 86 90 86 86 86 83
81 90 90 90 90 90 90 90 90 90 90 90 90 90 90 90 90 90 90 90 90 90 90 151 90 90 90 90 90 90 90 90 90 90 90 90 90 90 90 83
81 90 90 90 90 90 90 90 90 90 90 90 90 90 90 90 90 90 90 90 90 90 90 90 90 90 90 90 90 90 90 90 90 90 90 90 90 90 90 83
81 90 90 90 90 90 90 90 90 90 90 90 90 90 90 90 90 90 90 90 90 90 90 90 90 90 90 90 90 90 90 90 90 90 151 90 90 90 90 83
81 90 90 90 90 90 90 90 90 90 90 90 90 90 90 90 90 90 90 90 90 90 90 90 90 90 90 90 90 90 90 90 90 90 90 90 90 90 90 83
81 90 90 90 90 90 90 90 90 90 90 90 90 90 90 90 90 90 90 90 90 90 90 90 90 90 90 90 90 90 90 90 90 90 90 151 151 90 90 83
81 90 90 90 90 90 90 90 90 90 90 90 90 90 90 90 90 90 90 90 90 90 151 90 90 90 90 90 90 90 136 90 90 90 90 90 90 90 90 83
81 90 90 90 90 90 90 90 90 90 90 90 90 90 90 90 90 90 90 90 90 90 90 151 90 90 151 152 90 90 90 90 90 90 90 90 90 90 90 83
97 98 98 98 98 98 98 98 98 98 98 98 98 98 98 98 98 98 98 98 98 98 98 98 98 98 98 98 98 98 98 98 98 98 98 98 98 98 98 99
